---------
-E-------
----E----
-E-----P-
---------
-------E-
---------